████████████████
█░@░░░β░$████↘██
█░░░░███████░ξ██
██β█████████░░██
██░█████████░░██
██░█████████░░██
██∮█████████░░██
██░░░░░░░░░░░░██
██░░░████░░░░░██
██░░░█$$█░░░░░██
██░░░█ξξ█░░░░░██
██░░░█░░█░░░░░██
██░░░█░░█░░░░░██
██░░░█░░█░░░░░██
██∮░░░░░░░░░█↗██
████████████████