████████████████████████████████
█     β $████↘██████████████████
█    ███████ ξ██████████████████
██β█████████  ██████████████████
██ █████████  ██████████████████
██ █████████  ██████████████████
██∮█████████  ██████████████████
██            ██████████████████
██   ████     ██████████████████
██   █$$█     ██████████████████
██   █ξξ█     ██████████████████
██   █  █     ██████████████████
██   █  █     ██████████████████
██   █  █     ██████████████████
██∮         █↗██████████████████
████████████████████████████████