████████████████████████████████
█         ███ ██████████████████
█    ███████  ██████████████████
██ █████████  ██████████████████
██ █████████  ██████████████████
██ █████████  ██████████████████
██ █████████  ██████████████████
██            ██████████████████
██   ████     ██████████████████
██   █  █     ██████████████████
██   █  █     ██████████████████
██   █  █     ██████████████████
██   █  █     ██████████████████
██   █  █     ██████████████████
██          █ ██████████████████
████████████████████████████████