████████████████
█     β $████↘██
█    ███████ ξ██
██β█████████  ██
██ █████████  ██
██ █████████  ██
██∮█████████  ██
██            ██
██   ████     ██
██   █$$█     ██
██   █ξξ█     ██
██   █  █     ██
██   █  █     ██
██   █  █     ██
██∮         █↗██
████████████████