████████████████████████████████
██      ███████████████        █
██      █     █████████ █      █
██    █ █     █████████ █      █
███████           █     █      █
█████████     ███ █   █ █      █
█   █████     ███ █   █ █      █
█   ███████ █████ █   █ ████████
█                 █   █     ████
█   █████████████████ █████ ████
█       █     █     █       ████
█       █     █     █       ████
█                           ████
█       █     █     █       ████
████████████████████████████████