██████████████████████████████████
███     ███████████████         ██
███     ███████████████ █       ██
███     █     █████████ █       ██
███████ █     █████████ █       ██
███████           █     █       ██
█████████     ███ █   █ █       ██
█   █████     ███ █   █ █       ██
█   ███████ █████ █   █ ██████████
█                 █   █     ██████
█   █████████████████ █████ ██████
█       █     █     █       ██████
█   █   █     █     █       ██████
█   █         █     █       ██████
█ █████ █     █     █       ██████
█ ███   █     █     █           ██
█ ███ ███████ ███ ███ █████ █   ██
█ █     █           █     █ █   ██
█ █     █           █     █ █   ██
█ █     █           █     █ █   ██
█ █     █           █     █ ██████
█ █                       █     ██
█ ███ ███           ███ ███████ ██
█ █     █           █     █████ ██
█ █     █           █     █████ ██
█                           █    █
███     █           █     █ █    █
███     █           █     █ █    █
█████ ███████ ███ █████ ███ █    █
█       █     █     █   ███ █    █
█       █     █     █ █████ ███ ██
█                                █
█       █     █     ███       █  █
█       █     █     ███       █  █
█       ███ █████ ██████████████ █
█       ███                      █
███ ███████ ███████████ █████ ████
███     █   ███       █       ████
███     █   ███   █   ███     ████
███     █   ███   █     █     ████
███     █   ███   █████ █     ████
███         ███   █████ █     ████
███     █   █████ █████ █     ████
███     █         █████       ████
██████████████████████████████████